101111111101
100001100001
101100001101
101100001101
100001100001
100000000001
100100001001
000000000000
000000000000
100100001001
100000000001
100001100001
101100001101
101100001101
100001100001
101111111101
